SO ./sprites/so.png
NO ./sprites/no.png
WE ./sprites/we.png
EA ./sprites/ea.png

C 161,133,148
F 129,211,42

11111111111111111111111111111
	1000000000110000000000001
	100000000000000011110N011
11111111111111111111111111111