SO ./sprites/so.png
NO ./sprites/no.png
WE ./sprites/we.png
EA ./sprites/ea.png

C 12,20,69
F 124,252,0


			111111111111111111111111111111111111111111111
			10010000000000000000000000000000000000100001
			1000010000001111111111110000010000000010000111
			1000000000000000000011110000000000000010000001
			1000000000100001000011110000000010000010011111
		11111000000000000000000011110000100000000000001
		10000110000000001000000011110000S00100000011111
	11111000011000000100000000001111000000000000111
	100000000110000000000100010000000000000000001
	111110000110000000000000000011100000000000001
		100000000000011111111111111000000000000011111
		100000010000010000000000000000000000000000001
		100000000000010000000000000100000000000111111
	11111111100000000000000000000000000000000001
	100000001000000000000100000000000000000000001
	100000001000000001000000000001000000000000001
	100000001000000001000000000001000000000000001
	100000001000000001000000010001000000000000001
	100100101000000001111001000001000011111110001
	100000000000000000000000000000000000000000001
	111111111111111111111111111111111111111111111
