SO ./sprites/so.png
NO ./sprites/no.png
WE ./sprites/we.png
EA ./sprites/ea.png

C 161,133,148
F 129,211,42
1111111111
1000000001
1000100001
1000N00001
1111111111




