SO ./maps/bad_maps/map_errors_1.cub
NO ./maps/bad_maps/map_errors_2.cub

WE ./maps/bad_maps/map_errors_3.cub
EA ./maps/bad_maps/map_errors_4.cub

F 20,43,65
C 12,30,10



		1111111111111111111111111
		10001        111100000001
		10101111 111    100000001
		1001000111011111100000001
111111111011000010110000000000001
100000000011000001110111111111111
11110111111111111100000010001
111101111111   11101010010001
11000000110111110100000010001
10000000000000001100000010001
10000000000000001101010010001
1100000111010101111011110N0011
11110111 1110101 101111010001
11111111 1111111 111111111111



