SO ./sprites/so.png
NO ./sprites/no.png
WE ./sprites/we.png
EA ./sprites/ea.png

C 161,133,148
F 54,65,42
		1111111111111111111111111
		10001        111100000001
		10101111 111    100000001
		1001000111011111100000001
111111111011000010000000000000001
100000000011000001110111111111111
11110111111111111100000010001
111101111111   11101010010001
11000000110111110100000010001
10000000000000000000000010001
100N0000000000001101010010001
110000011101010111101111000011
11110111 1110101 101111010001
11111111 1111111 111111111111



