SO ./sprites/so.png
NO ./sprites/no.png
WE ./sprites/we.png
EA ./sprites/ea.png

C 161,133,148
F 129,211,42
1111111111
1000000001
1001010001
10001N1101
1111111011




